0,0,0,0,0,0,0,0
0,0,0,0,0,0,0,0
0,0,0,0,0,0,0,0
0,0,2,4,2,0,0,0
0,0,2,3,3,0,0,0
0,0,3,2,3,0,0,0
0,0,2,8,9,0,0,0
0,0,0,0,0,0,0,0
