0,0,0,0,0,0,0,0
0,0,0,0,0,0,0,0
0,2,2,9,2,2,2,0
0,3,4,3,3,2,2,0
0,3,4,8,3,2,2,0
0,2,3,3,3,2,2,0
0,0,0,0,0,0,0,0
0,0,0,0,0,0,0,0
