0,0,0,0,0,0,0,0
0,0,0,0,0,0,0,0
0,0,0,9,0,0,0,0
0,0,2,3,2,0,0,0
0,0,2,2,2,0,0,0
0,0,2,3,2,0,0,0
0,0,0,8,0,0,0,0
0,0,0,0,0,0,0,0