0,0,0,0,0,0,0,0
0,0,0,0,0,0,0,0
0,0,9,2,2,2,0,0
0,0,0,0,0,2,0,0
0,0,0,0,0,2,0,0
0,0,8,2,2,2,0,0
0,0,0,0,0,0,0,0
0,0,0,0,0,0,0,0

