0,0,0,0,0,0,0,0
0,0,0,0,0,0,0,0
0,0,2,2,0,0,0,0
0,2,3,3,2,0,0,0
0,2,3,2,2,0,0,0
0,0,3,2,0,0,0,0
0,0,8,2,9,0,0,0
0,0,0,0,0,0,0,0

