0,0,0,0,0,0,0,0
0,0,0,0,0,0,0,0
0,0,9,4,2,2,0,0
0,0,0,3,0,2,0,0
0,0,0,2,0,2,0,0
0,0,8,2,2,2,0,0
0,0,0,0,0,0,0,0
0,0,0,0,0,0,0,0

